Root	Root
ConcreteThing 	Root/ConcreteThing
LivingThing 	Root/ConcreteThing/LivingThing
People	Root/ConcreteThing/LivingThing/People
Person	Root/ConcreteThing/LivingThing/People/Person
Organization	Root/ConcreteThing/LivingThing/People/Organization
Supernature	Root/ConcreteThing/LivingThing/People/Supernature
Animal	Root/ConcreteThing/LivingThing/Animal
Mammal	Root/ConcreteThing/LivingThing/Animal/Mammal
Bird	Root/ConcreteThing/LivingThing/Animal/Bird
Fish	Root/ConcreteThing/LivingThing/Animal/Fish
Amphibian	Root/ConcreteThing/LivingThing/Animal/Amphibian
Reptile	Root/ConcreteThing/LivingThing/Animal/Reptile
Worm	Root/ConcreteThing/LivingThing/Animal/Worm
Insect	Root/ConcreteThing/LivingThing/Animal/Insect
Shellfish	Root/ConcreteThing/LivingThing/Animal/Shellfish
FictionalAnimal	Root/ConcreteThing/LivingThing/Animal/FictionalAnimal
Microorganism	Root/ConcreteThing/LivingThing/Microorganism
Plant	Root/ConcreteThing/LivingThing/Plant
Tree	Root/ConcreteThing/LivingThing/Plant/Tree
Bush	Root/ConcreteThing/LivingThing/Plant/Bush
Vine	Root/ConcreteThing/LivingThing/Plant/Vine
Herb	Root/ConcreteThing/LivingThing/Plant/Herb
LowPlant	Root/ConcreteThing/LivingThing/Plant/LowPlant
HighPlant	Root/ConcreteThing/LivingThing/Plant/HighPlant
NonLivingThing	Root/ConcreteThing/NonLivingThing
Food 	Root/ConcreteThing/NonLivingThing/Food
Grain	Root/ConcreteThing/NonLivingThing/Food/Grain
Vegetable	Root/ConcreteThing/NonLivingThing/Food/Vegetable
Meat 	Root/ConcreteThing/NonLivingThing/Food/Meat
Fruit 	Root/ConcreteThing/NonLivingThing/Food/Fruit
Beverage	Root/ConcreteThing/NonLivingThing/Food/Beverage
Seasoning	Root/ConcreteThing/NonLivingThing/Food/Seasoning
Dish	Root/ConcreteThing/NonLivingThing/Food/Dish
Artifact 	Root/ConcreteThing/NonLivingThing/Aritifact
Furniture 	Root/ConcreteThing/NonLivingThing/Aritifact/Furniture
Tool 	Root/ConcreteThing/NonLivingThing/Aritifact/Tool
Plaything 	Root/ConcreteThing/NonLivingThing/Aritifact/Plaything
Appliance	Root/ConcreteThing/NonLivingThing/Aritifact/Appliance
Machine 	Root/ConcreteThing/NonLivingThing/Aritifact/Machine
Vehicle 	Root/ConcreteThing/NonLivingThing/Aritifact/Vehicle
Instrument	Root/ConcreteThing/NonLivingThing/Aritifact/Instrument
Garment 	Root/ConcreteThing/NonLivingThing/Aritifact/Garment
Raiment 	Root/ConcreteThing/NonLivingThing/Aritifact/Raiment
Ornament 	Root/ConcreteThing/NonLivingThing/Aritifact/Ornament
Cosmetic 	Root/ConcreteThing/NonLivingThing/Aritifact/Cosmetic
Drug 	Root/ConcreteThing/NonLivingThing/Aritifact/Drug
Creation 	Root/ConcreteThing/NonLivingThing/Aritifact/Creation
Construction	Root/ConcreteThing/NonLivingThing/Aritifact/Construction
BuildingConstruction	Root/ConcreteThing/NonLivingThing/Aritifact/BuildingConstruction
FictionalObject	Root/ConcreteThing/NonLivingThing/FictionalObject
Part	Root/ConcreteThing/NonLivingThing/Part
AnimalPar	Root/ConcreteThing/NonLivingThing/Part/AnimalPar
PlantPar	Root/ConcreteThing/NonLivingThing/Part/PlantPar
ArtifactPar	Root/ConcreteThing/NonLivingThing/Part/PartOfArtifact
Substance	Root/ConcreteThing/NonLivingThing/Substance
Matter	Root/ConcreteThing/NonLivingThing/Substance/Matter
Solid	Root/ConcreteThing/NonLivingThing/Substance/Solid
Earth	Root/ConcreteThing/NonLivingThing/Substance/Earth
Liquid	Root/ConcreteThing/NonLivingThing/Substance/Liquid
Gas	Root/ConcreteThing/NonLivingThing/Substance/Gas
NaturalObject 	Root/ConcreteThing/NonLivingThing/NaturalObject
HeavenlyBodies 	Root/ConcreteThing/NonLivingThing/NaturalObject/HeaventlyBodies
NaturalPhenomenon	Root/ConcreteThing/NonLivingThing/NaturalObject/NaturalPhenomenon
Land 	Root/ConcreteThing/NonLivingThing/NaturalObject/Land
BodyOfWater 	Root/ConcreteThing/NonLivingThing/NaturalObject/BodyOfWater
Abstraction	Root/Abstraction
FieldOfKnowledge	Root/Abstraction/FieldOfKnowledge
Concept	Root/Abstraction/FieldOfKnowledge/Concept
Knowledge	Root/Abstraction/FieldOfKnowledge/Knowldege
Psychology	Root/Abstraction/FieldOfKnowledge/Psychology
State 	Root/Abstraction/State
Physiological	Root/Abstraction/State/Physiological
Stay	Root/Abstraction/State/Stay
Existence	Root/Abstraction/State/Existence
Contact	Root/Abstraction/State/Contact
Consume	Root/Abstraction/State/Consume
Will	Root/Abstraction/State/Will
Depend	Root/Abstraction/State/Depend
Action 	Root/Abstraction/Action/
BodilyRepsond	Root/Abstraction/Action/BodilyRepsond
BodilyFunction	Root/Abstraction/Action/BodilyFunction
Thinking	Root/Abstraction/Action/Thinking
Act	Root/Abstraction/Action/Act
Cognitive	Root/Abstraction/Action/Cognitive
Communicate	Root/Abstraction/Action/Communicate
Move	Root/Abstraction/Action/Move
Create	Root/Abstraction/Action/Create
Change	Root/Abstraction/Action/Change
PresentAndReceive	Root/Abstraction/Action/RresentAndReceive
Receive	Root/Abstraction/Action/Receive
Relation 	Root/Abstraction/Relation
Hypotaxis	Root/Abstraction/Relation/Hypotaxis
Conjugate	Root/Abstraction/Relation/Conjugate
Space	Root/Abstraction/Relation/Space
Time	Root/Abstraction/Relation/Time
Exist	Root/Abstraction/Relation/Exist
Compare	Root/Abstraction/Relation/Compare
SetOrGroup	Root/Abstraction/Relation/SetOrGroup
Attribute 	Root/Abstraction/Attribute
Quality  	Root/Abstraction/Attribute/Quality
Quantity  	Root/Abstraction/Attribute/Quantity
Characteristic  	Root/Abstraction/Attribute/Characteristic
Condition	Root/Abstraction/Attribute/Condition
SortOrType  	Root/Abstraction/Attribute/SortOrType
Value 	Root/Abstraction/Value
Definite 	Root/Abstraction/Value/Definite
Indefinite 	Root/Abstraction/Value/Indedinite
Unit 	Root/Abstraction/Unit
Conventional 	Root/Abstraction/Unit/Conventional
Time 	Root/Abstraction/Unit/Time
Administrative 	Root/Abstraction/Unit/Administrative